###########
###########
...........
...........
...........
...........
...........
..@........
###########
###########
