#######################################
.......................................
.......................................
.......................................
.......................................
.......................................
.......................................
.......................................
..########.............................
.......................................
.......................................
.......................................
.......................................
..@....................................
.......................................
#######################################
