#######################################
#######################################
.......................................
.......................................
.......................................
.......................................
.......................................
.......................................
..########.............................
.......................................
.......................................
.......................................
.......................................
..@....................................
#######################################
#######################################
